0 0 0 0 0 0 0 0 0 0 0 0 0 0 0 0
0 6 0 0 0 0 0 0 0 0 0 0 0 3 3 0
0 3 0 0 0 0 0 0 5 3 3 6 0 0 5 0
0 0 0 3 6 0 3 0 0 3 0 0 3 5 3 0
0 7 0 0 3 0 1 6 0 5 0 0 7 0 0 0
0 0 0 0 0 3 0 3 0 0 0 0 0 0 0 0
0 5 5 0 0 3 0 0 0 0 0 0 6 0 0 0
0 0 0 0 0 3 0 0 0 0 0 0 0 0 0 0
0 5 3 0 0 3 0 0 7 0 7 0 2 0 0 0
0 0 0 0 0 0 0 0 0 0 0 0 0 0 0 0
0 0 0 0 3 5 0 0 5 0 0 0 0 0 0 0
0 0 0 0 0 0 0 0 0 0 0 0 0 0 0 0