0 0 0 0 0 0 0 0 0 0 0 0 0 0 0 0
0 1 3 3 3 3 5 5 3 3 5 3 3 9 3 0
0 0 0 0 0 0 0 0 0 0 0 0 0 0 0 0
0 0 3 3 3 3 6 0 5 3 0 0 6 5 3 0
0 0 0 0 0 0 0 0 0 0 0 0 0 0 0 0
0 0 5 5 5 3 3 0 0 5 0 0 0 0 0 0
0 0 0 0 0 3 3 3 0 3 3 0 0 0 0 0
0 0 0 0 0 0 0 0 0 0 0 0 0 0 0 0
0 3 0 0 0 0 0 0 6 5 6 5 3 0 0 0
0 5 0 0 0 0 0 0 3 3 3 3 0 0 0 0
0 5 0 0 0 0 0 0 0 0 0 0 0 0 2 0
0 0 0 0 0 0 0 0 0 0 0 0 0 0 0 0