0 0 0 0 0 0 0 0 0 0 0 0 0 0 0 0
0 4 0 8 6 0 0 0 0 0 0 5 6 6 8 0
0 3 3 0 3 0 0 0 0 0 0 5 6 3 3 0
0 0 0 0 0 0 0 0 0 0 0 0 3 0 0 0
0 0 3 0 0 5 0 0 5 0 0 0 3 0 7 0
0 0 0 0 0 0 0 0 0 0 0 0 0 5 5 0
0 0 0 0 8 3 0 1 0 0 0 0 0 3 3 0
0 0 0 0 0 0 6 0 0 0 0 0 0 7 0 0
0 0 3 5 0 0 3 0 0 0 0 0 3 0 0 0
0 5 0 0 0 0 0 0 0 0 0 0 0 0 0 0
0 5 3 8 0 0 0 0 0 0 0 0 0 0 2 0
0 0 0 0 0 0 0 0 0 0 0 0 0 0 0 0