0 0 0 0 0 0 0 0 0 0 0 0 0 0 0 0
0 6 5 6 3 0 5 0 0 0 0 0 3 9 7 0
0 6 6 6 3 0 0 0 0 0 0 0 3 6 0 0
0 3 3 3 3 0 0 1 0 0 0 0 0 0 0 0
0 7 9 7 0 3 5 0 0 0 0 0 7 0 0 0
0 0 0 0 0 0 0 0 0 0 0 6 0 0 0 0
0 0 0 0 0 0 0 0 0 0 0 3 0 0 0 0
0 0 0 0 0 9 0 6 7 6 7 6 0 0 0 0
0 9 3 3 0 0 0 3 3 3 3 3 2 3 0 0
0 3 0 0 0 0 0 0 0 5 0 5 0 0 5 0
0 9 0 0 7 7 0 0 0 0 5 0 0 5 0 0
0 0 0 0 0 0 0 0 0 0 0 0 0 0 0 0