0 0 0 0 0 0 0 0 0 0 0 0 0 0 0 0
0 7 0 0 5 3 3 3 9 0 0 0 6 0 0 0
0 3 3 3 0 0 0 0 0 0 0 0 3 7 5 0
0 3 3 3 3 3 3 3 3 0 0 0 0 0 0 0
0 3 1 0 3 0 3 0 5 0 0 0 3 3 9 0
0 3 3 3 3 3 3 3 3 3 0 0 0 0 0 0
0 5 0 7 9 0 0 3 3 3 3 0 0 0 0 0
0 0 3 3 0 3 3 3 0 0 0 6 0 0 0 0
0 0 0 6 0 0 0 0 0 0 0 3 3 9 3 0
0 0 0 3 3 3 3 3 0 0 0 3 0 0 0 0
0 0 7 5 3 3 9 3 0 0 7 0 0 9 2 0
0 0 0 0 0 0 0 0 0 0 0 0 0 0 0 0