0 0 0 0 0 0 0 0 0 0 0 0 0 0 0 0
0 0 3 3 9 0 0 0 0 0 0 3 3 3 7 0
0 1 6 0 0 3 3 0 0 3 3 0 0 6 0 0
0 0 0 0 0 0 0 0 0 0 0 0 0 0 0 0
0 3 6 3 9 0 9 0 0 9 0 9 0 6 3 0
0 9 3 3 0 0 3 0 0 3 0 0 3 3 9 0
0 3 7 9 0 0 7 0 0 0 0 0 9 7 3 0
0 9 0 3 0 0 0 3 3 0 0 0 3 0 9 0
0 0 0 0 0 0 0 0 0 0 0 0 2 0 0 0
0 0 0 0 0 3 3 0 0 3 3 0 0 0 0 0
0 5 3 3 3 0 0 0 0 0 0 3 3 3 5 0
0 0 0 0 0 0 0 0 0 0 0 0 0 0 0 0