0 0 0 0 0 0 0 0 0 0 0 0 0 0 0 0
0 8 3 3 3 0 0 6 0 0 1 0 0 0 9 0
0 0 0 5 0 5 0 0 0 5 0 3 0 0 0 0
0 0 6 0 6 0 0 0 0 0 3 3 0 0 0 0
0 0 3 0 3 3 0 0 3 5 0 7 0 0 0 0
0 0 0 8 3 0 0 0 0 0 0 0 3 0 0 0
0 0 3 0 0 3 0 0 0 0 0 0 3 0 0 0
0 9 3 0 0 0 0 3 0 0 0 6 6 0 6 0
0 0 0 3 3 3 0 0 0 0 5 0 0 6 0 0
0 0 0 0 0 0 0 5 2 0 5 0 0 0 6 0
0 8 0 0 0 0 0 0 0 0 0 0 7 7 7 0
0 0 0 0 0 0 0 0 0 0 0 0 0 0 0 0