0 0 0 0 0 0 0 0 0 0 0 0 0 0 0 0
0 1 3 6 0 5 0 0 0 0 3 5 5 5 0 0
0 0 0 3 0 0 0 0 0 0 3 3 5 5 0 0
0 0 0 5 0 0 0 0 0 0 3 3 3 3 0 0
0 5 3 0 0 0 0 0 0 0 0 0 0 0 0 0
0 0 0 0 6 3 6 3 0 0 0 0 0 0 0 0
0 6 6 6 0 3 0 3 0 0 0 0 0 0 0 0
0 3 3 3 3 0 0 0 2 0 0 0 0 0 0 0
0 3 3 3 0 0 3 3 0 0 0 0 5 0 0 0
0 0 0 0 0 5 0 0 0 0 0 0 0 0 0 0
0 0 0 0 0 5 0 0 5 0 0 0 0 0 0 0
0 0 0 0 0 0 0 0 0 0 0 0 0 0 0 0