0 0 0 0 0 0 0 0 0 0 0 0 0 0 0 0
0 8 4 0 0 0 0 0 0 0 0 0 0 0 0 0
0 3 3 0 0 0 0 0 0 0 0 0 0 5 9 0
0 0 6 0 0 0 0 0 0 0 0 0 0 0 0 0
0 0 0 0 0 2 0 5 0 0 0 0 0 0 0 0
0 0 0 7 5 0 8 0 0 0 0 0 0 0 0 0
0 0 0 5 0 0 3 3 5 0 0 0 9 5 0 0
0 5 5 0 0 5 0 3 0 0 0 0 0 0 0 0
0 5 0 0 3 0 0 6 0 0 0 0 0 5 0 0
0 0 0 5 0 0 0 0 0 0 0 0 0 0 0 0
0 1 3 0 5 0 0 0 0 0 5 0 0 0 0 0
0 0 0 0 0 0 0 0 0 0 0 0 0 0 0 0