0 0 0 0 0 0 0 0 0 0 0 0 0 0 0 0
0 1 3 3 8 3 5 3 0 0 0 0 0 0 7 0
0 0 0 0 0 3 5 0 0 0 0 0 0 6 5 0
0 5 0 0 0 5 0 5 5 5 0 0 0 0 0 0
0 0 0 0 0 7 0 3 3 3 0 0 0 0 0 0
0 0 6 6 3 0 0 0 6 0 0 0 0 6 5 0
0 0 6 6 3 0 0 8 0 0 0 0 0 0 0 0
0 7 6 6 3 0 0 0 0 0 2 0 7 0 0 0
0 5 3 3 3 0 0 3 5 3 0 5 0 0 5 0
0 5 3 0 0 0 0 0 0 8 5 0 0 0 0 0
0 5 3 0 0 0 0 3 3 3 3 0 0 0 5 0
0 0 0 0 0 0 0 0 0 0 0 0 0 0 0 0